W W W W W W W W W W W W W W W W W W W
W S S S S S S S S W S S S S S S S S W
W S W W S W S S W W W S S W S W W B W
W S S S S W S S S S S S S W S S S S W
W S W W S W S W W W W W S W S W W S W
W S B S S S S S S W S S S S S S S S W
W S S W S W W W E W E W W W S W S S W
W S S W S W E E E E E E E W S W S S W
W S S S S W E W E W 2 W E W S S S S W
W W W W S S S W 1 E E W S S S W W W W
W S S S S W S W W W W W S W S S S S W
W S S W S W S S S B S S S W S W S S W
W S S W S W S W W S W W S W S W S S W
W S S S S S S S S S S S S S S S S S W
W B W W S W W W W S W W W W S W W B W
W S S W S W S S S P S S S S S W S S W
W W S W S W S W W S W W S W S W S W W
W S S S S S S S S W S S S W S S S S W
W S W W W S W W S S S W W W W W W S W
W S S S S S S S S S S S S S S S S S W
W W W W W W W W W W W W W W W W W W W